设计草图
首页

    顶部导航栏:
        Logo: 显示论坛名称或图标
        导航链接: 首页、板块、消息、个人资料
        搜索框: 允许用户搜索帖子和板块

    主要内容区:
        最新帖子: 按时间排序的帖子列表
        热门板块: 主要板块的链接或展示
        推荐内容: 根据用户兴趣推荐的帖子或板块

    侧边栏:
        论坛分类: 各个板块的列表
        热门话题: 当前热门讨论

板块页面

    顶部导航栏:
        同首页

    板块标题与描述:
        标题: 板块的名称
        描述: 板块的介绍

    帖子列表:
        帖子标题: 帖子的名称
        作者: 发帖者的名字
        发布时间: 发帖时间
        回复数: 讨论的数量

    侧边栏:
        子板块: 当前板块的子板块列表
        相关链接: 板块相关的链接

帖子页面

    顶部导航栏:
        同首页

    帖子标题与内容:
        标题: 帖子的标题
        内容: 帖子的详细内容

    用户信息:
        头像: 发帖者的头像
        用户名: 发帖者的名称
        注册时间: 发帖者的注册日期

    评论区:
        评论: 显示帖子的评论
        回复: 提供回复功能

    操作按钮:
        编辑: 编辑帖子
        删除: 删除帖子
        点赞: 点赞帖子
        举报: 举报不当内容

用户个人资料页面

    用户头像: 显示用户的头像
    基本信息:
        用户名: 用户的名字
        邮箱: 用户的邮箱地址
        注册日期: 用户注册的时间
    帖子和评论历史:
        帖子: 用户发表过的帖子列表
        评论: 用户评论过的帖子列表
    编辑个人信息:
        修改头像: 上传新的头像
        更新资料: 修改用户名、邮箱等信息